R 1400 1050
NO ./textures/wolf3d/redbrick.xpm
SO ./textures/wolf3d/greystone.xpm
WE ./textures/wolf3d/colorstone.xpm
EA ./textures/wolf3d/purplestone.xpm
S ./textures/sprite.xpm
F 0,153,15

C 0,0,0

111111111111111111111111111111111111111111
100000000000000000000000000000000000000001
100000000000000011111110001111111111111101
100000000000000111111100001111110111111101
100000000000001111111000001111100111111101
100000000000011111110000001111000111111101
100000000000111111100000001110000111111101
100000000001111111000000001100000111111101
100000000011111110000000001000000111111101
100000000111111100000000000000001111111001
100000001111111000000000000000011111110001
100000011111110000000000000000111111100001
100000111111100000000000000001111111000001
100001111111000000000000000011111110000001
100011111110000000000000000111111100000001
100111111100000000000000001111111000000101
101111111111111111111110001111111000001101
101111111111111111111110001111111000011101
101111111111111111111110001111111000111101
101111111111111111111110001111111001111101
101111111111111111111110001111111011111101
101111111111111111111110001111111111111101
100000000000000011111110000000000000000001
100000000000003011111110000000000000000001
100000000000000011111110002000000000000001
100000000000000011111110000000000000000001
100000000000000011111110006000000000000001
100000000000000011111110000000000000000001
100000000000000011111110002000000000000001
100000000000000000000000000000000000000001
111111111111111111111111111111111111111111
100000310000010000000000000000000000000001
130010000010000002000060000200002000000001
11111111111111000W000000000000000000000001
105040000000000000000000000000000000000001
111111111111111111111111111111111111111111