R 640 480
NO ./textures/wolf3d/redbrick.xpm
SO ./textures/wolf3d/greystone.xpm
WE ./textures/wolf3d/colorstone.xpm
EA ./textures/wolf3d/purplestone.xpm
S ./textures/sprite.xpm
F 0,153,15
C 0,0,0

111111111111111
100000000000001
100000020000001
100000000000001
100000000000001
100000000000001
100000000000001
1020000W0000201
100000000000001
100000000000001
100000000000001
100000000000001
100000020000001
100000000000001
111111111111111